0  0  0  -4  -9  4  2  -9  -2  0  0  0  0  0  0  -4  -9  -9  -9  -2  
0  0  0  -5  -3  4  2  -3  -8  0  0  0  0  0  0  -4  -9  -9  -9  -2  
0  0  0  0  0  5  8  0  0  6  1  7  0  0  0  14  18  18  15  -2  
-1  -7  0  0  0  0  0  0  0  4  16  0  0  0  0  0  -5  -3  -3  -8  
-9  -2  0  11  0  0  0  0  0  12  0  0  0  6  7  0  0  0  0  0  
15  -2  0  12  0  0  0  0  0  12  0  0  6  9  9  1  1  1  7  0  
-9  -2  0  12  0  0  0  0  0  12  0  17  3  3  3  3  9  9  9  1  
-9  -2  0  12  0  0  0  0  0  12  0  0  0  0  0  0  5  3  9  9  
-9  -2  0  12  0  0  11  0  0  12  0  0  0  0  0  0  0  0  5  9  
-9  -2  0  12  0  0  0  0  0  4  7  0  0  0  0  0  0  0  0  4  
1  1  1  2  0  0  0  0  0  4  9  1  1  1  1  1  1  1  1  9  
9  9  9  2  0  0  0  0  0  4  9  9  9  9  9  9  9  9  9  9  
0


14
175 184
229 200
254 230
272 255
294 292
320 326
359 259
397 201
412 158
429 122
441 88
477 74
775 216
973 267

25 350 0

0

750 425 

625 350

2
750 238
950 288

2
500 50
850 50

1
0 220 0

0

2
100 450
300 350

0