9  9  9  9  9 9 9  8  0  10 0  0 0 0 0 0 0 0 0 0  
9  9  3  9  9 9 2  0  0  0  0  0 0 0 0 0 0 0 0 0  
3  8  0  5  3 3 8  0  0  0  0  0 0 0 0 0 0 0 14 13 
0  0  0  0  0 0 0  0  0  0  0  0 0 0 0 13 0 0 0 0  
0  0  0  0  0 0 0  0  0  11 0  0 0 0 0 0 0 0 0 0  
0  0  0  0  0 0 0  0  0  12 0  13 0 0 0 0 0 0 0 0  
0  0  0  6  1 1 7  0  0  12 0  0 0 0 0 0 0 13 0 0  
13 13 13 9  3 3 9  7  0  12 0  0 0 13 0 0 0 0 0 0  
0  0  0  10 0 0 10 0  0  12 0  0 0 0 0 0 0 0 0 0  
0  0  0  0  0 0 0  0  0  12 0  0 0 0 0 0 0 0 0 0  
1  1  1  7  0 0 6  1  1  9  7  0 0 0 0 13 0 0 6 1  
9  9  9  2  0 0 4  9  9  9  2  0 0 0 0 0 0 0 4 9  

0

8
125 215
372 301
524 473
576 324
773 475
874 279
969 183
614 74

10 400 0

3
50 150 0
100 150 0
400 0 0

920 25

450 50

1
0 338 

2
100 100
100 450

1
920 470 0 

2
2 150 250 300 250 300 250
1 300 475 400 475 300 475

0

0