0  0  0  -5  -3  -3  4  9  9  9  8  -2  0  0  0  0  5  3  3  9  
0  0  0  0  0  0  4  9  9  8  -9  -2  0  0  0  0  0  0  0  4 
0  0  0  0  0  0  4  9  8  -9  -9  -2  0  0  0  0  0  0  0  4  
0  0  14  13  15  0  5  8  0  -5  -3  -8  0  0  17  1  1  1  1  9  
0  0  0  12  0  0  0  0  0  0  0  0  0  0  0  5  3  9  9  9  
0  0  0  12  0  14  13  13  13  13  13  15  0  0  0  0  0  5  9  9    
0  0  0  10  0  0  0  0  0  0  0  0  0  0  0  0  0  0  5  9   
0  0  0  0  0  0  0  0  0  0  0  0  0  0  0  0  0  0  0  4  
0  0  0  0  0  0  0  0  0  0  0  0  0  0  0  0  0  0  0  4  
0  0  0  11  0  0  0  0  0  0  0  0  0  0  0  0  0  0  0  4  
0  0  0  4  1  1  1  1  1  1  1  7  0  0  6  1  1  1  1  9  
1  1  1  4  9  9  9  9  9  9  9  2  0  0  4  9  9  9  9  9 

0

11
225 225
225 275
225 325
50 200
50 265
50 350
50 400
90 400
130 400
873 458
650 525

725 350 1

3
0 500 1
50 500 1
100 500 1

850 75

750 0

1
850 488

1
100 100

0

2
3 250 450 550 450 250 450
1 400 225 550 225 550 225

1
200 450